animaltfdb	motif2factors
AP-2	AP-2
ARID	ARID_BRIGHT
bHLH	bHLH
CSD	CSD
CUT	CUT_Homeodomain
DM	DM
E2F	E2F
ETS	Ets
Fork_head	Forkhead
GCM	GCM
Homeobox	Homeodomain
HSF	HSF
IRF	IRF
MBD	MBD
Miscellaneous	Mixed
MYB	Myb_SANT
NF-YA	CBF_NF-Y
P53	p53
PAX	Paired_box
Pou	Homeodomain_POU
RFX	RFX
Runt	Runt
SAND	SAND
T-box	T-box
TEA	TEA
TF_bZIP	bZIP
TF_others	Unknown
THAP	THAP_finger
zf-C2H2	C2H2_ZF
zf-C2HC	C2HC_ZF
zf-GATA	GATA